##############################
##############################
#   ##############     #######
### ##          ## ### #### ##
###    #### ### ## ### #### ##
###### #### ### ## ### #### ##
###### #### ###    ### #### ##
######      ########## #### ##
##     #### ##########      ##
## ######## ##################
## ########           ##    ##
##      ##### ### ### ## #####
### ### ##### ### ### ## #####
### ###   ### ### ### ## #####
### ##### ####### ###    #####
######### ####### ############
######### ####################