###############################
###############################
#   ##############     ########
### ##          ## ### #### ###
###    #### ### ## ### #### ###
###### #### ### ## ### #### ###
###### #### ###    ### #### ###
######      ########## #### ###
##     #### ##########      ###
## ######## ###################
## ########           ##    ###
##      ##### ### ### ## ######
### ### ##### ### ### ## ######
### ###   ### ### ### ##     ##
##  ##### ####### ###    ### ##
## ###### ####### ########## ##
## #      ####### #####    # ##
## # ############    #### ## ##
## #   ###   ####### ##   ## ##
## ###     # # ##    ## ##   ##
## ######### # ## ##### ## ####
##    ###### # ##       ## ####
##### ###### # ####### ### ####
##### ##     #         ### ####
#     ## ###############   ####
########        ######## ######
###### ### #### ########   ####
######     ####    ####### ####
######### ######## ###     ####
###################### ########
###################### ########