#######################################
###            ####   #        ########
### ## ############ #   ### ###### ## #
### ## ##      #### ####### ###       #
### ## ## #### #### #####       #######
### ## ##   ##    # ####### ###########
#   ## ########## #       #############
######    ####### ### ### #############
####### #             ### #############
###     ###############################
### ######    ############         ####
### ###    ## #####    ### ####### ####
### ### ##### ## ## ##     ##### # ####
###     ##### ## ## ###### ##### # ####
############# ##    ###    ##### #  ###
#####         ######### ######## ## ###
###### #### #### ###### ########    ###
###### #### ####        ########### ###
###### ####      ################## ###
################################### ###