####################################################################
##### ############       ###############                       #####
#####         #### #####   ###     ##### ##################### #####
##### #### ## #### ########### ### ##### #                   # #####
##### #### ## #### ####   #### ### ##### # ################# # #####
##### #### ## #### #### # #### ###    ## # #          ### ## # #####
##### #### ##         ### #### ###### ## # # ####### #### ## # #####
##### #### ###########         ###### ## # # #       #### ## # #####
##### ####    #      # ### ########## ## # # # ########## ## # #####
##### ####### # #### # ### ########## ## # # #            ## # #####
##### #######   ####   ### ##########    # # ############### # #####
#   # #################### ########## #### #                 # #####
# # # ####### ######     # ####       #### ################### #####
# # # ##      ####### ## # #### ##########                     #####
# # # ## ############ ##   #### ### ############### ################
# # # ## ##########   ######### ###     ########### ######       ###
# # # ##      ##### ########### ####### ########### ###### ##### ###
# # # ## #### ##### ###########         ########### ###### ##### ###
# #   ## #### ###   #### ########################## ###### ##### ###
# ###### #### ##### #### ########################## ############ ###
#        #### #####      ##########################              ###
############# ######################################################